....................
....................
....................
....................
.....D..............
G..................G
D......DD.D..GG....D
D......DD.D.GDDG...D
DGGGGGGGGGGGDDDDGGGD
DDDDDDDDDDDDDDDDDDDD
SSSSDDDDSDDDDDSSSDDD
DSSSSSDDSDDSSSSSSSSD