.............................................
.............................................
.............................................
.............................................
.....D.......................................
G..................G....G......S....S....S...
D......DD.D..GG....D....G......S....S....S...
D......DD.D.GDDG...D....G......S....S....S...
DGGGGGGGGGGGDDDDGGGDDDDDDGGGGGGGGGGGGGGGGGGGG
DDDDDDDDDDDDDDDDDDDDDDDDDDDDDDDDDDDDDDDDDDDDD
SSSSDDDDSDDDDDSSSDDDDDDDDDDDDDDDDDDDDDDDDDDDD
DSSSSSDDSDDSSSSSSSSDDDDDDDDDDDDDDDDDDDDDDDDDD