............................................................................................
............................................................................................
......GGG................................................................................GGG
.....GDDD...............................................................................GDDD
GGGGGDDDD..P...........................................................................GDDDD
DDDDDCCDD.GGG.........................................................................GDSDDD
DDSSDCCDD......GGGG...............................DD..DD...........GG.........GGGGGGGGDDSSDD
DDSSSDCDD.....G.......GGGG.......................D........G.......GDDG........DSDDCCSCCCSSDD
DDSSDDDDD....G.......GSSCSGG..........GG.....GG............G.....GDDDDG......PDDDDDDCCCDDDDD
DDDDCCDDDGGGGDGGGGGGGDDDCSDDGGG...GGGGDDGGGGGDDGGGGGGGGGGGGDGGGGGDDDDDDGGGGGGSDDDCCDDDDDDDDD
DDDDCCCSSDDDDSDSSSDSSSSSCSSSDSDGGGDDDCCCSDSDSSSSSDSCSSSSSSDDDSDDDDDDDDDDDDDDDDSSSSSSSSDDDDDD
SSSSSSSSSSSSSSSSSSSSSSSSSSSSSSSSSSSSSSSSSSSSSSSSSSSSSSSSSSSSSSSSSSSSSSSSSSSSSSSSSSSSSSSSSSSS
