................DD..........................................................................
................DD..........................................................................
......GGG.......DD..........................................................................
.....GDDD.......DD..........................................................................
....GDDDD..P....DD..........................................................................
....DCCDD.GGG.........................................................................GGGG..
....DCCDD......GGGG...............................DD..DD...........GG.........GGGGGGGGDDSSG.
...GSDCDD.....G.......GGGG.......................D........G.......GDDG........DSDDCCSCCCSSDG
..GSDDDDD....G.......GSSCSGG..........GG.....GG............G.....GDDDDG......PDDDDDDCCCDDDDD
DDDDCCDDDGGGGDGGGGGGGDDDCSDDGGG...GGGGDDGGGGGDDGGGGGGGGGGGGDGGGGGDDDDDDGGGGGGSDDDCCDDDDDDDDD
DDDDCCCSSDDDDSDSSSDSSSSSCSSSDSDGGGDDDCCCSDSDSSSSSDSCSSSSSSDDDSDDDDDDDDDDDDDDDDSSSSSSSSDDDDDD
SSSSSSSSSSSSSSSSSSSSSSSSSSSSSSSSSSSSSSSSSSSSSSSSSSSSSSSSSSSSSSSSSSSSSSSSSSSSSSSSSSSSSSSSSSSS
