....................
.............GGGGG..
............GDDDDDG.
...........GDDDSDDDG
...........DDDSSDDDD
..........GDDDSSDDDD
G.........DDDSSDDDDD
DG.......GDDDSSDDDDD
DDGGGGGGGDDDDSSSDDDD
DDDDDDDDDDDDDSSSDDDD
SSSSSSSSSSSSSSSSSSSS
SSSSSSSSSSSSSSSSSSSS