.....D.......................................
.....D.......................................
.....D.......................................
.....D.......................................
.....D.......................................
G..................G....G......S....S....S...
D......GGGGG.GG....D....G......S....S....S...
D.P...GDSDSDGDDG...D....G......S....S....S...
DGGGGGDDDDDDDDDDGGGDDDDDDGGGGGGGGGGGGGGGGGGGG
DDDDDDDSDDDSDDCCDSSDDDDDDDDDDDDDDDDDDDDDDDDDD
DSCCSDDDSSSDDSCCCSSSDDDDDDDDDDDDDDDDDDDDDDDDD
DDSSSSSDDDDDDDDDSSSSSDDDDDDDDDDDDDDDDDDDDDDDD