............................................................................................
............................................................................................
......GGG..............................................................................GGGGG
.....GDDD...............................................................................GDDD
GGGGGDDDD..P...........................................................................DDDDD
DDDDDCCDD.GGG.........................................................................GDDDDD
DDSSDCCDD......GGGG........................................................CCCCGGGGGGGDDDDDD
DDSSSDCDD.....G.......SSSS.................................................SSSSDDDDDDDDDDDDD
DDSSDDDDD....G.......SSSSSSS..................................................DDDDDDDDDDDDDD
DDDDDDDDDGGGGGGGGGGGGGGGGGGGGGGGGGGGGGGGGGGGGGGGGGGGGGGGGGGGGGGGGGGGGGSSSSSSSSDDDDDDDDDDDDDD
DDDDCCCSSDDDDSDSSSDSSSDSCSSSDSDDDDDDDSSDSDSDSDSDSDSDSSSSSSDDDSDDDDDDDDDDDDDDDDSSSSSSSSDDDDDD
DDDDDDDDDDSCSSSDSSSSSDSCSCSSSDDDDSDDDDSDSDDDDDDDDDDDDDDDDDDDDDDDDDDDDDDDDDDDDDDDDDDDSSSSSSSS
