.............................................
.............................................
.............................................
.............................................
.............................................
G...................................S....S...
D............D...........................S...
D.P.........DDD....D....G...S..S.........S...
DGGGGGDDDDDDDDDDGGGDDDDDDGGGGGGGGGGGGGGGGGGGG
DDDDDDDSDDDSDDCCDSSDDDDDDDDSDDDSDDDDDDDDDDDDD
DSCCSDDDSSSDDSCCCSSSDDDDDDDDSDSDDDDDDDDDDDDDD
DDSSSSSDDDDDDDDDSSSSSDDDDDDDDSDDDDDDDDDDDDDDD