............................................................................................
............................................................................................
......GGG...................................................................................
.....GDDD........................................................GGGGGGGG...................
....GDDDD..P....................................................GSSSSSSSSGGGGGG.............
....DCCDDGGGG...................................................S.......SSSSSSSG......GGGG..
....DCCDD......GGGG...............................DD..DDDD....................SGGGGGGGDDSSG.
...GSDCDD.....G.......GGGG.......................D........G........SS.........SSDDCCSCCCSSDG
..GSDDDDD....G.......GDSCDGG..........GG.....GG...........DG......SSSS.......PDDDDDDCCCDDDDD
DDDDCCDDDGGGGDGGGGGGGDDDCSDDGGG...GGGGDDGGGGGDDGGGGGGGGGGGGDGGGGGSSSSSCCCSSSSSDDDCCDDDDDDDDD
DDDDCCCSSDDDDSDSSSDSSSSSCSSSDSDGGGDDDCCCSDSDSSSSSDSCSSSSSSDDDSDDDDDDDDDCCDDDDDSSSSSSSSDDDDDD
SSSSSSSSSSSSSSSSSSSSSSSSSSSSSSSSSSSSSSSSSSSSSSSSSSSSSSSSSSSSSSSSSSSSSSSSSSSSSSSSSSSSSSSSSSSS
