....................
....................
....................
....................
....................
G..................G
D............GG....D
D...........GDDG...D
DGGGGGGGGGGGDDDDGGGD
DDDDDDDDDDDDDDDDDDDD
SSSSDDDDSDDDDDSSSDDD
DSSSSSDDSDDSSSSSSSSD